FrSkyPixelOsd	KEYWORD1

begin	KEYWORD2

cmdInfo	KEYWORD2
cmdReadFont	KEYWORD2
cmdWriteFont	KEYWORD2
cmdGetCamera	KEYWORD2
cmdSetCamera	KEYWORD2
cmdGetActiveCamera	KEYWORD2
cmdGetOsdEnabled	KEYWORD2
cmdSetOsdEnabled	KEYWORD2
cmdGetSettings	KEYWORD2
cmdSetSettings	KEYWORD2
cmdSaveSettings	KEYWORD2
cmdTransactionBegin	KEYWORD2
cmdTransactionCommit	KEYWORD2
cmdTransactionBeginProfiled	KEYWORD2
cmdTransactionBeginResetDrawing	KEYWORD2
cmdSetStrokeColor	KEYWORD2
cmdSetFillColor	KEYWORD2
cmdSetStrokeAndFillColor	KEYWORD2
cmdSetColorInversion	KEYWORD2
cmdSetPixel	KEYWORD2
cmdSetPixelToStrokeColor	KEYWORD2
cmdSetPixelToFillColor	KEYWORD2
cmdSetStrokeWidth	KEYWORD2
cmdSetLineOutlineType	KEYWORD2
cmdSetLineOutlineColor	KEYWORD2
cmdClipToRect	KEYWORD2
cmdClearScreen	KEYWORD2
cmdClearRect	KEYWORD2
cmdDrawingReset	KEYWORD2
cmdDrawChar	KEYWORD2
cmdDrawCharMask	KEYWORD2
cmdDrawString	KEYWORD2
cmdDrawStringMask	KEYWORD2
cmdDrawBitmap	KEYWORD2
cmdDrawBitmapMask	KEYWORD2
cmdMoveToPoint	KEYWORD2
cmdStrokeLineToPoint	KEYWORD2
cmdStrokeTriangle	KEYWORD2
cmdFillTriangle	KEYWORD2
cmdFillStrokeTriangle	KEYWORD2
cmdStrokeRect	KEYWORD2
cmdFillRect	KEYWORD2
cmdFillStrokeRect	KEYWORD2
cmdStrokeEllipseInRect	KEYWORD2
cmdFillEllipseInRect	KEYWORD2
cmdFillStrokeEllipseInRect	KEYWORD2
cmdCtmReset	KEYWORD2
cmdCtmSet	KEYWORD2
cmdCtmTranstale	KEYWORD2
cmdCtmScale	KEYWORD2
cmdCtmRotateRad	KEYWORD2
cmdCtmRotateDeg	KEYWORD2
cmdCtmRotateAboutRad	KEYWORD2
cmdCtmRotateAboutDeg	KEYWORD2
cmdCtmShear	KEYWORD2
cmdCtmShearAbout	KEYWORD2
cmdCtmMultiply	KEYWORD2
cmdCtmTranslateRev	KEYWORD2
cmdCtmScaleRev	KEYWORD2
cmdCtmRotateRevRad	KEYWORD2
cmdCtmRotateRevDeg	KEYWORD2
cmdCtmRotateAboutRevRad	KEYWORD2
cmdCtmRotateAboutRevDeg	KEYWORD2
cmdCtmShearRev	KEYWORD2
cmdCtmShearAboutRev	KEYWORD2
cmdCtmMultiplyRev	KEYWORD2
cmdCtmI16Translate	KEYWORD2
cmdCtmU16Rotate	KEYWORD2
cmdCtmI16TranslateRev	KEYWORD2
cmdCtmU16RotateRev	KEYWORD2
cmdContextPush	KEYWORD2
cmdContextPop	KEYWORD2
cmdDrawGridChar	KEYWORD2
cmdDrawGridString	KEYWORD2
cmdDrawGridChar2	KEYWORD2
cmdDrawGridCharMask2	KEYWORD2
cmdDrawGridString2	KEYWORD2
cmdWidgetSetConfigAhi	KEYWORD2
cmdWidgetSetConfigSidebar	KEYWORD2
cmdWidgetSetConfigGraph	KEYWORD2
cmdWidgetSetConfigCharGauge	KEYWORD2
cmdWidgetDrawAhiRad	KEYWORD2
cmdWidgetDrawAhiDeg	KEYWORD2
cmdWidgetDrawSidebar	KEYWORD2
cmdWidgetDrawGraph	KEYWORD2
cmdWidgetDrawCharGauge	KEYWORD2
cmdWidgetErase	KEYWORD2
cmdReboot	KEYWORD2
cmdWriteFlash	KEYWORD2
setFontMetadataSize	KEYWORD2
setFontMetadataOffset	KEYWORD2
setFontMetadataRect	KEYWORD2
setFontMetadataColors	KEYWORD2
clearFontMetadata	KEYWORD2

osd_error_t	KEYWORD3
osd_point_t	KEYWORD3
osd_size_t	KEYWORD3
osd_rect_t	KEYWORD3
osd_chr_data_t	KEYWORD3
osd_bitmap_opts_t	KEYWORD3
osd_color_t	KEYWORD3
osd_outline_t	KEYWORD3
osd_tv_std_t	KEYWORD3
osd_cmd_info_response_t	KEYWORD3
osd_cmd_settings_response_t	KEYWORD3
osd_unit_t	KEYWORD3
osd_widget_id_t	KEYWORD3
osd_widget_ahi_style_t	KEYWORD3
osd_widget_ahi_options_t	KEYWORD3
osd_widget_ahi_config_t	KEYWORD3
osd_widget_sidebar_options_t	KEYWORD3
osd_widget_sidebar_config_t	KEYWORD3
osd_widget_graph_options_t	KEYWORD3
osd_widget_graph_config_t	KEYWORD3
osd_widget_chargauge_config_t	KEYWORD3

OSD_MAX_FONT_DATA_SIZE	LITERAL1
OSD_CMD_ERR_NONE	LITERAL1
OSD_CMD_ERR_UNKNOWN_CMD	LITERAL1
OSD_CMD_ERR_NO_COMMAND	LITERAL1
OSD_CMD_ERR_PAYLOAD_TOO_SMALL	LITERAL1
OSD_CMD_ERR_BUF_TOO_SMALL	LITERAL1
OSD_CMD_ERR_PAYLOAD_INVALID	LITERAL1
OSD_CMD_ERR_INTERNAL	LITERAL1
OSD_CMD_ERR_CANT_PERFORM	LITERAL1
OSD_CMD_ERR_OUT_OF_MEMORY	LITERAL1
OSD_CMD_ERR_ALREADY_DONE	LITERAL1
OSD_CMD_ERR_RESPONSE_INGORED	LITERAL1
OSD_CMD_ERR_OTHER	LITERAL1
BITMAP_OPT_NONE	LITERAL1
BITMAP_OPT_INVERSE	LITERAL1
BITMAP_OPT_SOLID_BACKGROUND	LITERAL1
BITMAP_OPT_ERASE_TRANSPARENT	LITERAL1
COLOR_BLACK	LITERAL1
COLOR_TRANSPARENT	LITERAL1
COLOR_WHITE	LITERAL1
COLOR_GREY	LITERAL1
OUTLINE_TYPE_NONE	LITERAL1
OUTLINE_TYPE_TOP	LITERAL1
OUTLINE_TYPE_RIGHT	LITERAL1
OUTLINE_TYPE_BOTTOM	LITERAL1
OUTLINE_TYPE_LEFT	LITERAL1
TV_STD_NTSC	LITERAL1
TV_STD_PAL	LITERAL1
WIDGET_ID_AHI	LITERAL1
WIDGET_ID_SIDEBAR_0	LITERAL1
WIDGET_ID_SIDEBAR_1	LITERAL1
WIDGET_ID_GRAPH_0	LITERAL1
WIDGET_ID_GRAPH_1	LITERAL1
WIDGET_ID_GRAPH_2	LITERAL1
WIDGET_ID_GRAPH_3	LITERAL1
WIDGET_ID_CHARGAUGE_0	LITERAL1
WIDGET_ID_CHARGAUGE_1	LITERAL1
WIDGET_ID_CHARGAUGE_2	LITERAL1
WIDGET_ID_CHARGAUGE_3	LITERAL1
WIDGET_AHI_STYLE_STAIRCASE	LITERAL1
WIDGET_AHI_STYLE_LINE	LITERAL1
WIDGET_AHI_OPTION_NONE	LITERAL1
WIDGET_AHI_OPTION_SHOW_CORNERS	LITERAL1
WIDGET_SIDEBAR_OPTION_NONE	LITERAL1
WIDGET_SIDEBAR_OPTION_LEFT	LITERAL1
WIDGET_SIDEBAR_OPTION_REVERSE	LITERAL1
WIDGET_SIDEBAR_OPTION_UNLABELED	LITERAL1
WIDGET_SIDEBAR_OPTION_STATIC	LITERAL1
WIDGET_GRAPH_OPTION_NONE	LITERAL1
WIDGET_GRAPH_OPTION_BATCHED	LITERAL1